Basement########~##################################################
################-##################################################
################-#############-@-##################################
################-############-----####--------"--------############
################-###########-------###-###############-############
################-##############-######-#############--@--##########
################-----*----#####-#?--@------?########-----##########
################-########-#####-#-----------########----"##########
################-########-#####-#-----------##########-############
################-#####--------#-#----------------------############
################----?-----------------------#######################
######################+-------#-#----------?#######################
###############################-###################################
######-!-#-!-#-!-#-!-#-!-#####---#####-!-#-!-#-!-#-?-#-!-#-!-######
######---#---#---#---#---####-----####---#---#---#---#---#---######
#-?@###-###-###-###-###-#####-----#####-###-###-###-###-###-###@--#
#+---------------------------------------------------------------+#
#-?@###-###-###-###-###-#####-----#####-###-###-###-###-###-###@--#
######---#---#---#---#---####-----####---#---#---#---#---#---######
######-!-#-!-#-!-#-!-#-!-####-----####-!-#-!-#-!-#-?-#-!-#-!-######
#############################-----#################################
#############################-----#################################
###############################=###################################