Basement########~##################################################
################-##################################################
################-#############-@-##################################
################-############-@-@-####-----------------############
################-###########@-----@###-###############-############
################-##############-######-#############--@--##########
################-----*----#####-#?--@------?########@@@@@##########
################-########-#####-#-----------########--@--##########
################-########-#####-#-----"----@##########-############
################-#####@------"#-#----------------------############
################----?-----@-----------------#######################
######################@-------#-#----@-----?#######################
###############################-###################################
######-!-#-!-#-!-#-!-#-!-#####---#####-!-#-!-#-!-#-?-#-!-#-!-######
######---#---#---#---#---####@-@-@####---#---#---#---#---#---######
#-?@###-###-###-###-###-#####-----#####-###-###-###-###-###-###@--#
#+---------------------------------------------------------------+#
#-?@###-###-###-###-###-#####-----#####-###-###-###-###-###-###@--#
######---#---#---#---#---####-----####---#---#---#---#---#---######
######-!-#-!-#-!-#-!-#-!-####-----####-!-#-!-#-!-#-?-#-!-#-!-######
#############################-----#################################
#############################-----#################################
###############################=###################################